11111001111111111111111111111111111101101111100111
11111000000000001000000000011110011111100110100111
00000001101011001011001100010000000011101110000000
00000001001010001011000100010110011011000000000000
11111000100100000000000011010100001011100000110011
10111001111111111001000011010110011011101111110111
10000000001111111000000000011000000011100111110111
10000000101100000000001111111010000111101100100011
10001100101101111100000001111111100001001110110111
10001100101000101100100001101110101101100100000011
10000000101010100100001000000000000100000111110111
10000000001010110101001001111011111101001101100111
11111110010010110100011111111111000001101100110111
11111110011010110000110111000000010111100001100011
11110000001000111110010111010111011111100011100001
11110010001011101110000111000111000101000011111001
11000011001001100010100110000001101100001001000001
10010011001101100010111110011001101110001011101101
10010000000101101110111110000001100001001001101101
10111111111100001100000001110111001111001101100001
10011110001101101101110101110110011001100001111111
11000001101100101101110101100011011010000001111111
10011101101101101100010101100010001011100001000001
10111101101100001111011101111110011001101001101011
10000000000000001100011101111110111100101101101011
10000001100000001100001000001110000110101101100011
11001000011100001110001011100000110010100001100011
11001100011100001111111011100000010000100000000011
10000000000000011101101000001110010000100000110000
01000000000000000000000000011110010011110000110000
11111111111111111111011111111111111111111110000111
11111111111111111111111111111111111111111111111111
